wwwwwwwwwwwwww
w------^-----w
w------------w
w---------wwww
w--^------w
w---------w
w----p----w
w---------w
w-------^-w
wwwwwwwwwww