wwww wwwwww
w--w w----w
w--www----w
^---------^
^--^------^
w---------w
w----p----w
w---------w
w---------w
w^^^www^^^w